591	623	655	687	719	751	783	815	847	879	911	943	975	1007	1039	1071	1103	1135	1167	1199	1231	1263	1295	1327	1359	1391	1423	1455	1487	1519	1551	1583
592	624	656	688	720	752	784	816	848	880	912	944	976	1008	1040	1072	1104	1136	1168	1200	1232	1264	1296	1328	1360	1392	1424	1456	1488	1520	1552	1584
593	625	657	689	721	753	785	817	849	881	913	945	977	1009	1041	1073	1105	1137	1169	1201	1233	1265	1297	1329	1361	1393	1425	1457	1489	1521	1553	1585
594	626	658	690	722	754	786	818	850	882	914	946	978	1010	1042	1074	1106	1138	1170	1202	1234	1266	1298	1330	1362	1394	1426	1458	1490	1522	1554	1586
595	627	659	691	723	755	787	819	851	883	915	947	979	1011	1043	1075	1107	1139	1171	1203	1235	1267	1299	1331	1363	1395	1427	1459	1491	1523	1555	1587
596	628	660	692	724	756	788	820	852	884	916	948	980	1012	1044	1076	1108	1140	1172	1204	1236	1268	1300	1332	1364	1396	1428	1460	1492	1524	1556	1588
597	629	661	693	725	757	789	821	853	885	917	949	981	1013	1045	1077	1109	1141	1173	1205	1237	1269	1301	1333	1365	1397	1429	1461	1493	1525	1557	1589
598	630	662	694	726	758	790	822	854	886	918	950	982	1014	1046	1078	1110	1142	1174	1206	1238	1270	1302	1334	1366	1398	1430	1462	1494	1526	1558	1590
599	631	663	695	727	759	791	823	855	887	919	951	983	1015	1047	1079	1111	1143	1175	1207	1239	1271	1303	1335	1367	1399	1431	1463	1495	1527	1559	1591
600	632	664	696	728	760	792	824	856	888	920	952	984	1016	1048	1080	1112	1144	1176	1208	1240	1272	1304	1336	1368	1400	1432	1464	1496	1528	1560	1592
601	633	665	697	729	761	793	825	857	889	921	953	985	1017    1049	1081	1113	1145	1177	1209	1241	1273	1305	1337	1369	1401	1433	1465	1497	1529	1561	1593
602	634	666	698	730	762	794	826	858	890	922	954	986	1018	1050	1082	1114	1146	1178	1210	1242	1274	1306	1338	1370	1402	1434	1466	1498	1530	1562	1594
603	635	667	699	731	763	795	827	859	891	923	955	987	1019	1051	1083	1115	1147	1179	1211	1243	1275	1307	1339	1371	1403	1435	1467	1499	1531	1563	1595
604	636	668	700	732	764	796	828	860	892	924	956	988	1020	1052	1084	1116	1148	1180	1212	1244	1276	1308	1340	1372	1404	1436	1468	1500	1532	1564	1596
605	637	669	701	733	765	797	829	861	893	925	957	989	1021	1053	1085	1117	1149	1181	1213	1245	1277	1309	1341	1373	1405	1437	1469	1501	1533	1565	1597
606	638	670	702	734	766	798	830	862	894	926	958	990	1022	1054	1086	1118	1150	1182	1214	1246	1278	1310	1342	1374	1406	1438	1470	1502	1534	1566	1598
607	639	671	703	735	767	799	831	863	895	927	959	991	1023	1055	1087	1119	1151	1183	1215	1247	1279	1311	1343	1375	1407	1439	1471	1503	1535	1567	1599
608	640	672	704	736	768	800	832	864	896	928	960	992	1024	1056	1088	1120	1152	1184	1216	1248	1280	1312	1344	1376	1408	1440	1472	1504	1536	1568	1600
609	641	673	705	737	769	801	833	865	897	929	961	993	1025	1057	1089	1121	1153	1185	1217	1249	1281	1313	1345	1377	1409	1441	1473	1505	1537	1569	1601
610	642	674	706	738	770	802	834	866	898	930	962	994	1026	1058	1090	1122	1154	1186	1218	1250	1282	1314	1346	1378	1410	1442	1474	1506	1538	1570	1602
611	643	675	707	739	771	803	835	867	899	931	963	995	1027	1059	1091	1123	1155	1187	1219	1251	1283	1315	1347	1379	1411	1443	1475	1507	1539	1571	1603
612	644	676	708	740	772	804	836	868	900	932	964	996	1028	1060	1092	1124	1156	1188	1220	1252	1284	1316	1348	1380	1412	1444	1476	1508	1540	1572	1604
613	645	677	709	741	773	805	837	869	901	933	965	997	1029	1061	1093	1125	1157	1189	1221	1253	1285	1317	1349	1381	1413	1445	1477	1509	1541	1573	1605
614	646	678	710	742	774	806	838	870	902	934	966	998	1030	1062	1094	1126	1158	1190	1222	1254	1286	1318	1350	1382	1414	1446	1478	1510	1542	1574	1606
615	647	679	711	743	775	807	839	871	903	935	967	999	1031	1063	1095	1127	1159	1191	1223	1255	1287	1319	1351	1383	1415	1447	1479	1511	1543	1575	1607
616	648	680	712	744	776	808	840	872	904	936	968	1000 1032	1064	1096	1128	1160	1192	1224	1256	1288	1320	1352	1384	1416	1448	1480	1512	1544	1576	1608
617	649	681	713	745	777	809	841	873	905	937	969	1001 1033	1065	1097	1129	1161	1193	1225	1257	1289	1321	1353	1385	1417	1449	1481	1513	1545	1577	1609
618	650	682	714	746	778	810	842	874	906	938	970	1002 1034	1066	1098	1130	1162	1194	1226	1258	1290	1322	1354	1386	1418	1450	1482	1514	1546	1578	1610
619	651	683	715	747	779	811	843	875	907	939	971	1003 1035	1067	1099	1131	1163	1195	1227	1259	1291	1323	1355	1387	1419	1451	1483	1515	1547	1579	1611
620	652	684	716	748	780	812	844	876	908	940	972	1004 1036	1068	1100	1132	1164	1196	1228	1260	1292	1324	1356	1388	1420	1452	1484	1516	1548	1580	1612
621	653	685	717	749	781	813	845	877	909	941	973	1005 1037	1069	1101	1133	1165	1197	1229	1261	1293	1325	1357	1389	1421	1453	1485	1517	1549	1581	1613
622	654	686	718	750	782	814	846	878	910	942	974	1006 1038	1070	1102	1134	1166	1198	1230	1262	1294	1326	1358	1390	1422	1454	1486	1518	1550	1582	1614