91 91 91 91 92 92 92 92 92 92 92 92 92 92 92 92 92 92 92 92 92 91 91 91 91 91 91 91 91 91 91 91
91 91 94 91 91 91 92 92 92 92 92 92 92 92 92 92 92 92 92 91 91 91 91 91 91 91 91 91 91 91 91 91
91 91 95 91 94 91 91 91 92 92 92 92 92 92 92 92 92 91 91 94 91 91 91 91 91 91 91 91 91 91 91 91
92 96 91 91 95 91 91 91 91 91 92 92 92 92 92 91 91 91 91 95 91 91 91 91 91 91 91 91 91 91 91 91
92 92 92 91 91 91 91 91 91 91 91 91 91 91 91 91 91 91 91 91 91 91 91 91 91 91 91 91 91 91 91 91
97 92 92 96 91 91 91 91 91 91 91 91 91 91 91 91 91 91 91 91 91 91 91 91 91 91 91 91 91 91 91 91
93 98 92 92 92 91 91 91 91 91 91 91 91 91 91 91 91 91 91 91 91 91 91 91 91 91 91 91 91 91 91 91
93 93 98 92 92 96 91 91 91 91 94 91 91 91 91 91 91 91 91 91 91 91 91 91 91 91 91 91 91 91 91 91
93 93 93 92 92 92 91 91 91 91 95 91 91 91 91 91 91 91 91 91 91 91 91 91 91 91 91 91 91 91 91 91
93 93 93 98 92 92 91 91 91 91 91 91 91 91 91 91 91 91 91 91 91 91 91 91 91 91 91 91 91 91 91 91
93 93 93 93 92 92 92 91 91 91 91 91 91 91 91 91 91 91 91 91 91 91 91 91 91 91 91 91 91 91 91 91
93 93 93 93 93 92 92 91 91 91 91 91 91 91 91 91 91 91 91 91 91 91 91 91 91 91 91 91 91 91 91 91
93 93 93 93 93 92 92 91 91 91 91 91 91 91 91 91 91 91 91 91 91 91 91 91 91 91 91 91 91 91 91 91
93 93 93 93 93 92 92 96 91 91 91 91 91 91 91 91 91 91 91 91 91 91 91 91 91 91 91 91 91 91 91 91
93 93 93 93 93 92 92 92 92 91 91 91 91 91 91 91 91 91 94 91 91 91 91 91 91 91 91 91 91 91 91 91
93 93 93 93 93 93 92 92 92 91 91 91 91 91 91 91 91 94 95 91 91 91 91 91 91 91 91 91 91 91 91 91
93 93 93 93 93 93 98 92 92 91 91 91 91 91 91 91 91 95 91 91 91 91 91 91 91 91 91 91 91 91 91 91
93 93 93 93 93 93 93 92 92 92 91 91 91 91 91 91 91 91 91 91 91 91 91 91 91 91 91 91 91 91 91 91
93 93 93 93 93 93 93 98 92 92 92 91 92 92 92 91 91 91 91 91 91 91 91 91 91 91 91 91 91 91 91 91
93 93 93 93 93 93 93 93 92 92 92 92 92 92 92 92 92 92 92 101 101 91 91 91 91 91 91 94 91 91 91 91
93 93 93 93 93 93 93 93 98 92 92 92 92 100 98 92 92 92 92 92 92 91 91 91 91 91 91 95 91 91 91 91
93 93 93 93 93 93 93 93 93 93 93 93 93 93 93 93 98 97 92 92 92 91 91 91 91 91 91 91 94 91 91 91
93 93 93 93 93 93 93 93 93 93 93 93 93 93 93 93 93 93 93 92 92 92 92 91 91 91 91 91 95 91 91 91
93 93 93 93 93 93 93 93 93 93 93 93 93 93 93 93 93 93 93 92 92 92 92 91 91 91 94 91 91 91 91 91
93 93 93 93 93 93 93 93 93 93 93 93 93 93 93 93 93 93 93 93 92 92 92 91 91 91 95 91 91 91 91 91
93 93 93 93 93 93 93 93 93 93 93 93 93 93 93 93 93 93 93 93 93 97 92 92 92 92 92 92 92 92 92 92
93 93 93 93 93 93 93 93 93 93 93 93 93 93 93 93 93 93 93 93 93 93 92 92 92 92 92 92 92 92 92 92
93 93 93 93 93 93 93 93 93 93 93 93 93 93 93 93 93 93 93 93 93 93 93 93 93 93 93 93 93 93 93 93
93 93 93 93 93 93 93 93 93 93 93 93 93 93 93 93 93 93 93 93 93 93 93 93 93 93 93 93 93 93 93 93
93 93 93 93 93 93 93 93 93 93 93 93 93 93 93 93 93 93 93 93 93 93 93 93 93 93 93 93 93 93 93 93
93 93 93 93 93 93 93 93 93 93 93 93 93 93 93 93 93 93 93 93 93 93 93 93 93 93 93 93 93 93 93 93
93 93 93 93 93 93 93 93 93 93 93 93 93 93 93 93 93 93 93 93 93 93 93 93 93 93 93 93 93 93 93 93