114	118	118	118	118	118	118	118	118	118	118	118	118	118	118	118	118	118	118	118	118 118	118	118	118	122	126	126	126	126	126	126
117	118	118	118	118	118	118	118	118	118	118	118	118	118	118	118	118	118	118	118	118	118	118	118	118	118	115	115	131	130	126	126
120	121	127	118	118	118	118	118	118	118	118	118	118	118	118	118	118	118	118	118	118	118	118	118	118	118	118	118	131	130	115	122
126	126	117	118	118	118	118	118	118	118	118	118	118	118	118	118	118	118	118	118	118	118	118	118	118	118	118	118	131	130	118	119
126	126	126	121	127	118	118	118	118	118	118	118	118	118	118	118	118	118	118	118	118	118	118	118	118	118	118	118	131	130	118	118
129	126	126	126	121	121	121	127	118	118	118	118	118	118	118	118	118	118	118	118	118	118	118	118	118	118	118	118	131	130	118	118
108	129	126	126	126	126	126	120	118	118	118	118	118	118	118	118	118	118	118	118	118	118	118	118	118	118	118	118	131	130	118	118
108	108	108	129	126	126	126	120	121	121	121	121	121	121	121	121	121	121	121	121	121	121	121	121	127	118	118	118	131	130	118	118
108	108	108	108	108	129	126	126	126	126	126	126	126	126	126	126	126	126	126	126	126	126	126	126	120	121	127	118	131	130	118	118
108	108	108	108	108	108	108	129	126	126	126	126	126	126	126	126	126	126	126	126	126	126	126	126	126	126	120	118	131	130	118	118
108	108	108	108	108	108	108	108	108	108	108	108	108	108	108	108	108	108	108	129	126	126	126	126	126	126	126	120	131	130	118	118
108	108	108	108	108	108	108	108	108	108	108	108	108	108	108	108	108	108	108	108	108	108	108	125 129	126	126	126	133	132	118	118
108	108	108	108	108	108	108	108	108	108	108	108	108	108	108	108	108	108	108	108	108	108	108	125	108	129	126	126	126	126	118	118
108	111	111	111	112	108	108	108	108	108	108	108	108	108	108	108	125	108	108	108	108	108	108	108	108	108	129	126	126	126	126	121
113	102	102	102	107	108	108	108	108	108	108	108	108	108	108	108	108	108	108	125	108	108	108	108	108	108	108	128	126	126	126	126
102	102	102	102	110	111	112	108	108	108	108	108	108	108	108	108	108	108	108	108	108	108	108	108	108	108	108	108	126	126	126	126
102	102	102	102	123	102	110	111	111	112	108	108	108	108	108	108	108	108	108	108	108	108	108	108	108	108	108	108	126	126	126	126
102	102	102	102	124	102	102	102	102	110	112	108	108	108	108	108	108	108	108	108	108	108	108	108	108	108	108	126	126	126	126	126
102	102	102	123	102	102	102	102	102	102	110	111	112	108	108	108	108	108	108	108	108	108	108	108	108	108	108	126	126	126	126	126
102	102	102	124	102	102	102	102	102	102	102	102	107	108	108	108	108	108	108	108	108	108	108	108	108	108	108 126	126	114	118	118
102	102	102	102	102	102	102	102	102	123	102	102	107	108	108	108	108	108	108	108	108	108	108	108	108	108	108	126	126	114	118	118
102	102	102	102	102	123	102	102	123	124	102	102	110	111	112	108	108	108	108	108	108	108	108	108	108	108	108	126	126	118	118	118
102	102	102	102	102	124	102	123	124	102	102	102	102	102	107	108	108	108	108	108	108	108 108	108	108	108	108	126	126	118	118	118
102	102	102	102	102	102	102	124	102	102	123	102	102	102	107	108	108	108	108	108	108	108	108	108	108	108	108	126	126	118	118	118
102	102	102	123	102	102	102	102	102	102	124	102	102	102	107	108	108	125	108	108	108	108	108	108	108	126	126	126	126	114	118	118
102	102	102	124	102	102	102	102	102	102	102	102	102	104	108	108	108	108	108	108	108	108	108	108	108	126	126	126	126	118	118	118
102	102	102	102	102	123	102	102	102	102	102	102	102	111	112	108	108	108	108	108	108	108	108	108	126	126	114	115	118 118	118	118
102	102	102	102	102	124	102	102	102	102	102	102	103	104	105	108	108	108	108	108	108	108	126	126	126	126	114	118	118	118	118	118
102	102	102	102	102	102	102	102	102	102	102	103	108	108	108	108	108	108	108	108	108	126	126	126	126	121	121	118	118	118	118	118
102	102	102	102	102	103	104	106	102	103	104 108	108	108	108	108	108	108	126	126	126	126	121	121	121	118	118	118	118	118	118	118
102	102	102	102	102	102	112	109	102	107	108	108	108	108	108	108	108	108	126	126	114	121	118	118	118	118	118	118	118	118	118	118
102	102	102	102	103	104	105	108 108	108	108	108	108	108	108	125	108	108	126	126	117	118	118	118	118	118	118	118	118	118	118	118