401	401	401	401 398	398	398	398	398	398	398	401	403	415	416	417	418	419	402	421	134 134	134	134	134	134	145	397	401	401	401	401
401	401	401	399	137	148	151	151	151	151	151	397	401	403	404	405	406	407	408	423	134	134	134	134	134	134	150	146	397	401	401	401
401	401	399	146	152	235	236	237	238	239	240	145	397 409	410	411	412	413	399	152	306	271	272	273	274	275	134	145	388	401	401	401
401	396	146	152	134	241	242	243	244	245	246	150	146	397	398	398	398	399	147	134	276	277	278	279	280	281	134	145	391	401	401	401
401	399	147	134	134	247	248	249	250	251	252	134	150	151	151	151	151	151	152	134	282	283	284	285	286	287	134	145	397	401 401	401
401	390	147	134	135	253	254	255	256	257	258	134	135	134	134	134	134	135	134	134	288	289	290	291	292	293	134	150	146 394 401	401
401	396	147	134	136	259	260	261	262	263	264	134	136	134	134	134	134	136	134	134	294	295	296	297	298	299	134	134	145	394	401	401
398	399	147	134	134	265	266	267	268	269	270	134	134	134	134	134	134	134	134	134	300	301	302	303	304	305	134	134	145	394	401	401
146	146	147	134	134	134	145	146	138	139	141	141	141	141	142	134	134	134	144	144	144	144	146	146	147	134	134	134	145	394	401	401
151	151	152	134	134	134	150	143	146	146	146	146	146	146	147	134	134	134	145	146	146	146	146	146	148	134	134	134	145	397	401	401
134	134	134	134	134	134	134	134	134	134	134	134	150	146	147	134	134	134	145	146	152	134	134	134	134	134	134	134	150	146	397	398
134	134	134	134	134	134	134	134	134	134	134	134	134	146	147	134	134	134	145	146	134	134	134	134	134	134	134	134	134	150	151	151
134	134	154	155	156	157	158	159	134	134	134	140	141	146	138	144	144	144	137	146	141	142	134	134	307	308	309	310	311	312	134	134
134	134	160	170	171	172	173	174	135	134	134	145	146	146	146	146	146	146	146	146	146	147	134	134	313	314	315	316	317	318	134	134
134	134	175	176	177	178	179	180	136	134	134	145	146	146	146	146	146	146	146	146	146	147	134	134	319	320	321	322	323	324	134	134
134	134	181	182	183	184	185	186	134	134	134	145	146	146	146	146	146	146	146	146	146	147	134	135	325	326	327	328	329	330	134	134
134	134	187	188	189	190	191	192	134	135	134	145	146	137	146	146	137	146	146	137	146	147	134	136	331	332	333	334	335	336	134	135
134	135	193	194	195	196	197	198	134	136	134	145	146	146	388	400	389	400	390	146	146	147	134	134	337	338	339	340	341	342	134	136
134	136	134	134	145	146	138	139	134	134	134	150	146	146	391	401	392	401	393	146	146	152	134	134	134	140	137	147	134	134	134	134
134	134	134	134	150	143	146	146	146	146	146	146	146	146	394	401	395	401	396	146	146	146	146	146	146	146	148	152	134	135	134	134
134	134	134	134	134	134	134	134	134	134	134	134	145	146	397	398	398	398	399	146	147	134	134	134	134	134	134	134 134	136	134	134
134	134	134	134	134	134	134	134	134	135	134	134	145	137	146	146	137	146	146	137	147	134	134	134	134	134	134	134 134	134	134	134
134	134	134	134	134	134	134	134	134	136	134	140	146	146	146	146	137	146	146	146	146	142	134	135	134	134	134	134 134	134	134	134
134	134	199	200	201	202	203	204	134	134	134	145	146	146	146	146	137	146	146	146	146	147	134	136	343	344	345	346	347	348	134	134
134	134	205	206	207	208	209	210	134	134	134	145	146	146	146	146	137	146	146	146	146	147	134	134	349	350	351	352	353	354	135	134
134	134	211	212	213	214	215	216	140	141	141	146	146	146	146	146	137	146	146	146	146	138	139	142	355	356	357	358	359	360	136	134
134	134	217	218	219	220	221	222	145	146	151	146	146	146	146	146	137	146	146	137	146	146	146	147	361	362	363	364	365	366	134	134
134	134	223	224	225	226	227	228	145	147	134	145	146	146	146	146	137	146	146	146	146	147	145	147	367	368	369	370	380	381	134	134
134	134	229	230	231	232	233	234	145	147	134	145	146	146	146	146	137	146	146	146	146	147	145	147	382	383	384	385	386	387	134	134
134	135	134	134	145	146	138	141	137	147	134	150	151	146	146	146	137	146	146	146	151	152	145	146	146	146	138	142	134	134	134	134
134	136	135	134	150	143	151	151	151	152	134	134	134	145	146	146	137	146	146	147	134	134	150	151	151	151	151	152	134	134	134	134
134	134	136	134	134	134	134	134	134	134	134	134	134	145	146	146	137	146	146	147	134	134	134	134	134	134	134	134	134	134	134	134
